
{
  "name":"Devmap",
  "author":"Jon Ross",
  "description":"Don't let all of the absurdly overpowered enemies win!"
}
################################         #                  ########
#####################################   ##                       
#####################################   ##             ######          #####
#####################################   ##                                        ####
#####################################   ##@                                       ####
#####################################   ########  ####                         ##########                                        ##############
#####################################   ########  ####                         ##########                            ##########################
#####################################   ########  ############              ##################         #####                   ################
#####################################   #######   ############        #########################################                 ###############
#####################################       ###      ##########################        ##################################       ###############
#####################################       ###      ##########################        #####                                     ##############
#####################################       ##                                         ##                                    ##################
#####################################       ##                                                                         ########################
#####################################       ######    ########################                #################################################
#####################################       #####################################         #####################################################
#####################################       ###################################################################################################
#####################################       ###################################################################################################
#####################################   #######################################################################################################
#####################################   #######################################################################################################
#####################################   #######################################################################################################    
#####################################   #######################################################################################################
#####################################   #######################################################################################################
#####################################   #######################################################################################################
#####################################   #######################################################################################################
#####################################   #######################################################################################################
#####################################   #######################################################################################################
#####################################   #######################################################################################################
#####################################   #######################################################################################################
#####################################   #######################################################################################################    
#####################################   #######################################################################################################
#####################################   #######################################################################################################
#####################################   #######################################################################################################
#####################################   #######################################################################################################
#####################################   #######################################################################################################    
#####################################   #######################################################################################################
#####################################   #######################################################################################################
#####################################   #######################################################################################################
#####################################   #######################################################################################################
#####################################   #######################################################################################################
#####################################   #######################################################################################################
#####################################   #######################################################################################################
#####################################   #######################################################################################################
#####################################   #######################################################################################################    
#####################################   #######################################################################################################
#####################################   #######################################################################################################
#####################################   #######################################################################################################
#####################################   #######################################################################################################
#####################################   #######################################################################################################
#####################################   #######################################################################################################
#####################################   #######################################################################################################
#####################################   #######################################################################################################
#####################################   #######################################################################################################    
#####################################   #######################################################################################################
#####################################   #######################################################################################################
#####################################   #######################################################################################################
