
{
  "name":"Debug",
  "author":"Jon Ross",
  "gravity":-8,
  "description":"Don't let all of the absurdly overpowered enemies win!"
}
#####################################   ##                       
#####################################   ##                      ######
#####################################   ##         #                            #####
#####################################   ########  ###                        ############                  ####################################
#####################################   #######   ############    ###    #####################      ###########################################
#####################################       ##     ############################        ########################################################
#####################################       ##          ##################             ########################################################
#####################################       ##          ##################      @             #################################################
#####################################       ######    ########################                #################################################
#####################################       #####################################         #####################################################
#####################################       #####################################     #########################################################
#####################################       ###################################################################################################
#####################################   #######################################################################################################
#####################################   #######################################################################################################
#####################################   #######################################################################################################    
#####################################   #######################################################################################################
#####################################   #######################################################################################################
#####################################   #######################################################################################################
#####################################   #######################################################################################################
#####################################   #######################################################################################################
#####################################   #######################################################################################################
#####################################   #######################################################################################################
#####################################   #######################################################################################################
#####################################   #######################################################################################################    
#####################################   #######################################################################################################
#####################################   #######################################################################################################
#####################################   #######################################################################################################
#####################################   #######################################################################################################
#####################################   #######################################################################################################    
#####################################   #######################################################################################################
#####################################   #######################################################################################################
#####################################   #######################################################################################################
#####################################   #######################################################################################################
#####################################   #######################################################################################################
#####################################   #######################################################################################################
#####################################   #######################################################################################################
#####################################   #######################################################################################################
#####################################   #######################################################################################################    
#####################################   #######################################################################################################
#####################################   #######################################################################################################
#####################################   #######################################################################################################
#####################################   #######################################################################################################
#####################################   #######################################################################################################
#####################################   #######################################################################################################
#####################################   #######################################################################################################
#####################################   #######################################################################################################
#####################################   #######################################################################################################    
#####################################   #######################################################################################################
#####################################   #######################################################################################################
#####################################   #######################################################################################################
